border_size=1
usage=map

Wog         , Wog         , Wog         , Wo          , Wo          , Wo          , Wo          , Wo          , Wo          , Wo          , Wo          , Wo          , Wo          , Wo          , Wo          , Wo          , Wo          , Wo          , Wo          , Wo          , Wo          , Wo          , Wo          , Wo          , Wo          , Wo          , Wo          
Wo          , Wog         , Wo          , Wo          , Wo          , Ww          , Ww          , Wo          , Wo          , Wo          , Wo          , Wo          , Wo          , Ww          , Ww          , Ww          , Wo          , Wo          , Wo          , Wo          , Wo          , Wo          , Wo          , Wo          , Wo          , Wo          , Wo          
Wo          , Wo          , Wo          , Wo          , Ww          , Ds          , Ds          , Ww          , Wo          , Wo          , Wo          , Wo          , Ww          , Ds          , Ds          , Ds          , Ww          , Wo          , Wo          , Mm          , Wo          , Mm          , Mm          , Wo          , Wo          , Wo          , Wo          
Wo          , Wo          , Wo          , Wo          , Ds          , Ds          , Gg          , Ds          , Ds          , Ww          , Ww          , Ww          , Ww          , Ds          , Gg          , Ds          , Ww          , Wo          , Mm          , Mm          , Mm          , Mm          , Mm^Vhh      , Mm          , Wo          , Wo          , Wo          
Wo          , Wo          , Wo          , Ww          , Ds          , Gg          , Gs^Ft       , Gg          , Ds          , Ds          , Ds          , Ds          , Ds          , Gg          , Gs^Ft       , Gg          , Mm          , Mm          , Mm          , Mm          , Ms          , Ms          , Ms          , Mm          , Wo          , Wo          , Wo          
Wo          , Wo          , Wo          , Ww          , Ds          , Gg          , Gs^Ft       , Gs^Ft       , Gg          , Ds          , Ds          , Ds          , Gg          , Gs^Ft       , Gs^Ft       , Gg          , Gg          , Mm          , Mm          , Mm          , Ms          , Ms          , Ms          , Mm          , Wo          , Wo          , Wo          
Wo          , Wo          , Wo          , Ww          , Ds          , Gg          , Gs^Ft       , Gs^Ft       , Gs^Ft       , Ggf         , Gg          , Gg          , Gs^Ft       , Gs^Ft       , Gs^Ft       , Gg          , Gg          , Mm          , Mm          , Mm          , Mm          , Ms          , Ms          , Mm          , Wo          , Wo          , Wo          
Wo          , Wo          , Wo          , Ww          , Gg          , Gs^Ft       , Gs^Ft       , Gs^Ft       , Gs^Ft       , Gs^Ft       , Gs^Ft       , Gs^Ft       , Gs^Ft       , Gs^Ft       , Gs^Ft       , Gs^Ft       , Gg          , Mm          , Mm          , Mm          , Mm          , Mm          , Mm          , Mm          , Wo          , Wo          , Wo          
Wo          , Wo          , Ww          , Ds          , Gg          , Gs^Ft       , Gs^Ft       , Gs^Ft       , Gs^Ft       , Gs^Ft       , Gs^Ft       , Gs^Ft       , Gs^Ft       , Gs^Ft       , Gs^Ft       , Gs^Ft       , Gs^Ft       , Gg          , Mm          , Mm          , Mm          , Mm          , Mm          , Mm          , Wo          , Wo          , Wo          
Wo          , Ww          , Ds          , Ds          , Gs^Ft       , Gs^Ft       , Gs^Ft       , Gs^Ft       , Gs          , Gs^Ft       , Gs^Ft       , Gs^Ft       , Gs^Ft       , Gs^Ft       , Gs^Ft       , Gs^Ft       , Gs^Ft       , Gs^Ft       , Gs          , Gs          , Mm          , Mm          , Mm          , Mm          , Mm          , Wo          , Wo          
Wo          , Ww          , Ds          , Gs^Ft       , Gs^Ft       , Gs^Ft       , Gs^Ft       , Gs          , Gs^Ft       , Gs          , Gs^Ft       , Gs          , Gs          , Gs^Ft       , Gs^Ft       , Gs^Ft       , Gs^Ft       , Gs^Ft       , Gs          , Gs          , Wwt         , Mm          , Mm          , Mm          , Ds          , Wo          , Wo          
Wo          , Ww          , Ds          , Gs^Ft       , Gs^Ft       , Gs^Ft       , Gs^Ft       , Gs^Ft       , Gs^Ft       , Gs^Ft       , Gg^Ve       , Gs^Ft       , Gs^Ft       , Gs^Ft       , Gs^Ft       , Gs^Ft       , Gs^Ft       , Gs^Ft       , Gs          , Gs          , Wwt         , Gg          , Mm          , Mm          , Ds          , Wo          , Wo          
Wo          , Ww          , Ds          , Gs^Ft       , Gs^Ft       , Gs^Ft       , Gs^Ft       , Gs^Ft       , Gs^Ft       , Gs^Ft       , Gs^Ft       , Gs^Ft       , Gs^Ft       , Gs^Ft       , Gs^Ft       , Gs          , Gg          , Gg          , Gs^Ft       , Wwt         , Wwt         , Gg          , Ggf         , Mm          , Ds          , Wo          , Wo          
Wo          , Ww          , Ds          , Gg          , Gg          , Gs^Ft       , Gs^Ft       , Gs^Ft       , Gs^Ft       , Gs          , Gs^Ft       , Gs          , Gs^Ft       , Gs^Ft       , Gs^Ft       , Gg          , Gs^Ft       , Gs^Ft       , Gs^Ft       , Wwt         , Gs^Ft       , Gg          , Gg          , Ds          , Ds          , Wo          , Wo          
Wo          , Ww          , Ds          , Ds          , Gg          , Gs^Ft       , Gs^Ft       , Gs^Ft       , Gs^Ft       , Gs^Ft       , Ggf         , Gs^Ft       , Gs^Ft       , Gs^Ft       , Gg          , Gg          , Gs^Ft       , Gs^Ft       , Wwt         , Wwt         , Gs^Ft       , Gs^Ft       , Gs^Ft       , Ds          , Ww          , Wo          , Wo          
Wo          , Wo          , Ww          , Ds          , Ds          , Gg          , Gs^Ft       , Gs^Ft       , Gs^Ft       , Gs^Ft       , Gs^Ft       , Gs^Ft       , Gs^Ft       , Gg          , Gg          , Gs^Ft       , Gs^Ft       , Gs^Ft       , Wwt         , Gs^Ft       , Gs^Ft       , Gs^Ft       , Gs^Ft       , Ds          , Ww          , Wo          , Wo          
Wo          , Wo          , Ww          , Ds          , Ds          , Gg          , Gs^Ft       , Gs^Ft       , Gs^Ft       , Gs^Ft       , Gs^Ft       , Gg          , Gg          , Gg          , Gs^Ft       , Gs^Ft       , Wwt         , Wwt         , Wwt         , Gs^Ft       , Gs^Ft       , Gs^Ft       , Gs^Ft       , Ds          , Ds          , Wo          , Wo          
Wo          , Wo          , Wo          , Ww          , Ds          , Gg          , Gs^Ft       , Gs^Ft       , Gs^Ft       , Gg          , Gg          , Gg          , Gs^Ft       , Gs^Ft       , Gs^Ft       , Gs^Ft       , Wwt         , Gs^Ft       , Gs^Ft       , Gs^Ft       , Gs^Ft       , Gs^Ft       , Gs^Ft       , Ds          , Ds          , Wo          , Wo          
Wo          , Wo          , Wwt         , Ww          , Ds          , Gg          , Gg          , Gg          , Gg          , Gg          , Gs^Ft       , Ggf         , Gg          , Gs^Ft       , Gs^Ft       , Wwt         , Wwt         , Gs^Ft       , Gs^Ft       , Gs^Ft       , Gs^Ft       , Gs^Ft       , Gs^Ft       , Ds          , Ds          , Wo          , Wo          
Wo          , Wo          , Wo          , Ww          , Ds          , Ds          , Gs^Ft       , Gs^Ft       , Gg          , Gs^Ft       , Gs^Ft       , Gs^Ft       , Gg          , Gs^Ft       , Gs^Ft       , Wwt         , Gs^Ft       , Gs^Ft       , Gs^Ft       , Gs^Ft       , Gs^Ft       , Gs^Ft       , Gs^Ft       , Gg          , Ds          , Wo          , Wo          
Wo          , Wo          , Ww          , Ds          , Ds          , Ds          , Gs^Ft       , Gs^Ft       , Gs^Ft       , Gs^Ft       , Gs^Ft       , Ss          , Gs^Ft       , Ss          , Ss          , Wwt         , Ss          , Ss          , Gs^Ft       , Gs^Ft       , Gs^Ft       , Gs^Ft       , Gs^Ft       , Gg          , Ds          , Wo          , Wo          
Wo          , Wo          , Ww          , Ds          , Ds          , Ds          , Gg          , Gs^Ft       , Gs^Ft       , Gs^Ft       , Ss          , Ss          , Ss          , Wwt         , Ss          , Wwt         , Ww          , Ss          , Gs^Ft       , Gs^Ft       , Gg          , Gg          , Gg          , Gg          , Ds          , Wo          , Wo          
Wo          , Wo          , Ww          , Ds          , Ds          , Ds          , Gg          , Gs^Ft       , Gs^Ft       , Ss          , Ss          , Ss          , Wwt         , Wwt         , Wwt         , Wwt         , Ww          , Ss          , Gs          , Gs          , Gg          , Gs^Ft       , Gs^Ft       , Gg          , Ds          , Wo          , Wo          
Wo          , Ww          , Ds          , Ds          , Ds          , Gg          , Gg          , Gs^Ft       , Gs^Ft       , Ss          , Ss          , Wwt         , Wot         , Wot         , Wo          , Wot         , Ww          , Ww          , Ss          , Gs^Ft       , Gs^Ft       , Gs^Ft       , Gs^Ft       , Ds          , Ds          , Wo          , Wo          
Wo          , Ww          , Ds          , Ds          , Ds          , Ggf         , Gg          , Gs^Ft       , Gs^Ft       , Ss          , Ss^Vhs      , Ss          , Wot         , Wo          , Wo          , Wot         , Ww          , Ww          , Ss          , Gs^Ft       , Gs^Ft       , Gs^Ft       , Gs^Ft       , Ds          , Ds          , Wo          , Wo          
Wo          , Ww          , Ds          , Ds          , Ds          , Gg          , Gs^Ft       , Gs^Ft       , Gs^Ft       , Ss          , Ww          , Wot         , Ww          , Wot         , Wot         , Wot         , Ww          , Ss          , Ss          , Gs^Ft       , Gs^Ft       , Gs^Ft       , Gs^Ft       , Ds          , Ww          , Wo          , Wo          
Wo          , Ww          , Ds          , Ds          , Dd^Vda      , Gs^Ft       , Gs^Ft       , Gs^Ft       , Gg          , Gg          , Ww          , Ss          , Ww          , Ww          , Ww          , Ww          , Ww          , Ss          , Gs^Ft       , Gs^Ft       , Gs^Ft       , Gs^Ft       , Gs^Ft       , Ds          , Ww          , Wo          , Wo          
Wo          , Ww          , Ds          , Ds          , Ds          , Gs^Ft       , Ds          , Gg          , Ww          , Ww          , Ww          , Gs^Ft       , Ss          , Ww          , Ww          , Ww          , Ss          , Ss          , Gs^Ft       , Gs^Ft       , Gs^Ft       , Gs^Ft       , Gs^Ft       , Gg          , Ds          , Wo          , Wo          
Wo          , Ww          , Ds          , Ds          , Ds          , Ds          , Ds          , Ww          , Wo          , Wo          , Ss          , Gs^Ft       , Gs^Ft       , Ss          , Ss          , Ss          , Gs^Ft       , Gs^Ft       , Gs^Ft       , Gs^Ft       , Gs^Vht      , Gs^Ft       , Gs^Ft       , Gg          , Ds          , Wo          , Wo          
Wo          , Ww          , Ds          , Ds          , Ds          , Ww          , Ww          , Wo          , Wo          , Ww          , Gg          , Gs^Ft       , Gg          , Gg          , Gg          , Gs^Ft       , Gs^Ft       , Gs^Ft       , Gs          , Gs^Ft       , Gs^Ft       , Gs^Ft       , Gs^Ft       , Gs^Ft       , Ds          , Wo          , Wo          
Wo          , Wo          , Ww          , Ww          , Ww          , Wo          , Wo          , Wo          , Ww          , Gg          , Gs^Ft       , Gs^Ft       , Gg          , Gg^Ve       , Ggf         , Gs^Ft       , Gs^Ft       , Gg          , Gs          , Gs^Ft       , Gs^Ft       , Gs^Ft       , Gs^Ft       , Ds          , Ds          , Wo          , Wo          
Wo          , Wo          , Wo          , Wo          , Wo          , Wo          , Wo          , Ww          , Ds          , Gs^Ft       , Gs^Ft       , Gg          , Ggf         , Gg          , Gg          , Gs^Ft       , Gs^Ft       , Gg          , Gs^Ft       , Gs^Ft       , Gs^Ft       , Gs^Ft       , Gs^Ft       , Ds          , Ds          , Wo          , Wo          
Wo          , Wo          , Wo          , Wo          , Wo          , Ww          , Wo          , Ww          , Ww          , Gs^Ft       , Gs^Ft       , Gs^Ft       , Gs^Ft       , Gs^Ft       , Gg          , Gg          , Gg          , Gg          , Gs^Ft       , Gs^Ft       , Gs^Ft       , Gs^Ft       , Gs^Ft       , Gg          , Ds          , Wo          , Wo          
Wo          , Wo          , Ww          , Ww          , Ww          , Ds          , Ww          , Ds          , Ww          , Ww          , Ww          , Gs^Ft       , Gs^Ft       , Gs          , Gg          , Gs^Ft       , Gs^Ft       , Gs^Ft       , Gs^Ft       , Gs^Ft       , Gs^Ft       , Gs^Ft       , Gs^Ft       , Gg          , Ds          , Wo          , Wo          
Wo          , Ww          , Ds          , Ds          , Ds          , Gs^Ft       , Ds          , Gs^Ft       , Gs^Ft       , Gs^Ft       , Gs^Ft       , Gs^Ft       , Gs^Ft       , Gg          , Gg          , Gs^Ft       , Gs^Ft       , Gs^Ft       , Gs^Ft       , Gs^Ft       , Gs^Ft       , Gs^Ft       , Gs^Ft       , Ds          , Ds          , Wo          , Wo          
Wo          , Ww          , Ds          , Ds          , Ggf         , Gs^Ft       , Gs^Ft       , Gs^Ft       , Gs^Ft       , Gs^Ft       , Gs^Ft       , Gs^Ft       , Ggf         , Gg          , Gg          , Gg          , Gs^Ft       , Gs^Ft       , Gs^Ft       , Gs          , Gg          , Gs^Ft       , Gs^Ft       , Gg          , Ds          , Wo          , Wo          
Wo          , Wo          , Ww          , Ds          , Ds          , Gg          , Gg          , Gg          , Gg          , Gs^Ft       , Gg          , Gs^Vl       , Gg          , Gg          , Gg          , Gg          , Gg          , Gs^Ft       , Gs^Ft       , Gs          , Ww          , Gg          , Gs^Ft       , Gg          , Ds          , Wo          , Wo          
Wo          , Wo          , Ww          , Ds          , Ds          , Ds          , Ds          , Ds          , Gg          , Ds          , Ds          , Ds          , Ds          , Ds          , Ds          , Ggf         , Ds          , Ds          , Ds          , Ww          , Ww          , Ds          , Ds          , Ds          , Ww          , Wo          , Wo          
Wo          , Wo          , Ww          , Ds          , Ds          , Ds          , Ww          , Ds          , Ds          , Ds          , Ww          , Ds          , Ds          , Ds          , Ww          , Ds          , Ds          , Ww          , Ww          , Ww          , Wo          , Ww          , Ds          , Ww          , Wo          , Wo          , Wo          
Wo          , Wo          , Wo          , Ww          , Ds          , Ww          , Ww          , Ds          , Ds          , Ww          , Wo          , Ww          , Ww          , Ww          , Wo          , Ww          , Ww          , Wo          , Wo          , Wo          , Wo          , Wo          , Ww          , Wo          , Wo          , Wo          , Wo          
Wo          , Wo          , Wo          , Wo          , Ww          , Wo          , Wo          , Ww          , Ww          , Wo          , Wo          , Wo          , Wo          , Wo          , Wo          , Wo          , Wo          , Wo          , Wo          , Wo          , Wo          , Wo          , Wo          , Wo          , Wo          , Wo          , Wo          
Wo          , Wo          , Wo          , Wo          , Wo          , Wo          , Wo          , Wo          , Wo          , Wo          , Wo          , Wo          , Wo          , Wo          , Wo          , Wo          , Wo          , Wo          , Wo          , Wo          , Wo          , Wo          , Wo          , Wo          , Wo          , Wo          , Wo          
